M
8
5
// 5 Largish rooms for deeper testing
// Tests pipes without valid rooms and warping to the same room multiple times
//room 0
######..
.S.###..
...#.#2.
..#..#..
..#C.#..
..#..#..
..#..#.9
6.4#.#..
//room 1
........
........
........
..4.....
........
.9......
..8.....
...7..0.
//room 2
........
......6.
........
........
........
...0....
........
........
//room 3
87655678
........
.###....
...#....
...#....
.#####..
.#......
1.......
//room 4
........
789#....
...#3...
...####.
......8.
......9.
......7.
........
